SO ./path_to_the_south_texture

NO  ./path_to_the_north_texture

EA ./path_to_the_east_texture


C 225,30,0	
F 12,12,12

WE ./path_to_the_west_texture



111111111111111111111111111111111111
100000000000000000000000000000001
100000000000000000000000000000001
100000000000000000000000000000001
100000010010010000100100010000001
100000000000000000000000000000001
1000000000000E0000000000000000001
100000000000000000000000000000001
100000000000000000000000000000001
100000000000000000000000000000001
100000000000000000000000000000001
100000000000000000000000000000001111111111
100000000000000000000000000000000000000001
11111111111111111111111111111111111111111