SO textures/0.png

NO  textures/00.png

EA textures/01.png

WE textures/02.png

C 225,30,0
F 12,12,12

1111111111111111111111111111111111
1000000000000000000001000000000001
1000000000000000000000000000000001
1000000000000000000000000000000001
1000000100100100001001000100000001
1000000000000000000000000000000001
1000000000000N00000000000000000001
1010000000000000000001000000000001
1000000000000000000000000101000001
1000000000000000000000000001000001
1000000100001000000000001001000001
1000000000000000000000000001000001
1000000000000000000000000001000001
1111111111111111111111111111111111