SO textures/1.png                 
NO  textures/2.png 
EA textures/3.png
WE textures/4.png
C 255,255,255
F 255,255,255

1111111111111111111111111111111111111111111111111111111111111111
1000000000000000000001000000000011
1000000000000000000000000000000011
1000000000000000000000000000000011
1000000100100100001001000100000011
1000000000000000000000000000000011111111111111111111111111
10000000000000000000000000000001111111111111111111111111111
1010000000000000000001000000000011
1000000000000000000000000101000011
1000000000000000000000000001000011
10000001000010000E00000001001000011
111111111111111111111111111111111101
111111111111111111111111111111111101
111111111111111111111111111111111111