SO textures/0.png

NO  textures/00.png

EA textures/01.png

WE textures/02.png

C 225,30,0
F 12,12,12



1111111111
111111E111