SO ./path_to_the_south_texture

NO  ./path_to_the_north_texture

EA ./path_to_the_east_texture


C 225,30,0	
F 12,12,12

WE ./path_to_the_west_texture



1111111111111111111111111111111111
1000000000110000000000001111111111
1011000001110000000000001111101111
1001000000000000000000001111111111
1111111110110000011100000000000011
1000000000110000011101111111111111
1110111111111011100000010001111111
1111011111111101110101001000111111
1100000011010101110000001000111111
1000000000000000110000001000111111
1000000000000001101010010001111111
11000001110101011111011110N0111111
1111011111110101110111101000111111
1111111111111111111111111111111111
1111111111111111111111111111111111