SO ./path_to_the_south_texture

NO  ./path_to_the_north_texture

EA ./path_to_the_east_texture



C 225,30,0			

WE ./path_to_the_west_texture 


F 255,255,0

111111111111111111111111
1000000000110000000000001
1011000001110000000000001
100100000000000000000000111111111
111111111011000001110000000000001
100000000011000001110111111111111
1110111111111011100000010001
11110111111111011101010010001
11000000110101011100000010001
00000000000000001100000010000
1000000000000001101010010001
11000001110101011111011110N0111
11110111 1110101 101111010001
11111111 1111111 1111111111111