SO textures/1.png

NO  textures/2.png

EA textures/3.png

WE textures/4.png

C 0,0,0
F 0,0,0

1111111111111111111111111
1010101010101010101010101
1010101010101010101010101
1010101010101010101010101
1010101010101010101010101
111111111110N111111111111
1000000000000000000000001
1001000100000100000000001
1000000000000000000000001
1000000000000000000000001
1000000001000100000000001
1001000100001000000000001
1111111111111111111111111