SO textures/0.png
NO  textures/00.png
EA textures/01.png
WE textures/02.png

C 0,0,0
F 0,0,0

1111111111111
  1111111011111
 10000000N1
  11111111111111
