SO textures/0.png

NO  textures/00.png

EA textures/01.png

WE textures/02.png

C 0,0,0
F 0,0,0



111111
1001011111111
101011111111111
1101101000101
111111110S11111
111111111111111